...............................
      .        .        .     .
.  .  .  ....  .......  .  ....
.  .     .  .  .     .  .     .
.  .......  .  .  .  .  ....  .
.        .     .  .        .  .
.  ................  .......  .
.        .  .     .  .     .  .
.......  .  .  .  .  .  .  .  .
.        .     .  .  .  .     .
.  .............  .  .  ....  .
.  .                 .     .  .
.  .............  ....  .  .  .
.           .     .     .  .  .
..........  .  ..........  .  .
.           .  .  .        .  .
.  ....  ....  .  .  .......  .
.     .           .  .     .  .
....  .............  .  .  .  .
.                    .  .      
...............................
